%%%%%%
%    %
% %. %
% %%.%
%P. .%
%%%%%%
